11 11 11 11 17 17 17 12 14 10 11 16 11 11 11 11 11 11 11 11 11 0 0 0 0 0 0 0 0 0 0 0 
11 11 11 11 11 11 17 12 14 10 11 16 11 17 11 11 11 11 11 11 11 0 0 0 0 0 0 0 0 0 0 0 
47 47 47 47 47 32 11 12 14 10 11 16 11 17 11 17 17 11 17 17 11 11 0 0 0 0 0 0 0 0 0 0 
5 5 5 5 5 46 32 12 14 10 11 16 11 17 11 17 11 11 11 17 11 11 11 0 0 0 0 0 0 0 0 0 
23 23 23 23 5 5 37 12 14 10 11 16 11 17 11 17 17 17 17 17 11 11 11 0 0 0 0 0 0 0 0 0 
23 23 23 23 23 5 37 12 14 10 11 16 11 17 11 11 11 17 17 11 11 11 11 11 11 0 0 0 0 0 0 0 
23 23 23 23 23 5 37 12 14 10 11 16 11 17 17 11 11 11 11 11 11 11 11 11 11 11 11 11 0 0 0 0 
23 23 23 23 23 5 37 12 14 10 11 25 26 26 26 26 26 26 26 26 26 26 0 0 0 0 0 0 0 0 0 0 
23 23 5 5 5 5 37 12 14 10 11 11 11 11 11 11 11 11 11 11 11 11 11 11 11 0 0 0 0 0 0 0 
5 5 5 29 29 29 41 12 14 10 11 11 11 17 17 17 17 11 11 11 11 11 11 0 0 0 0 0 0 0 0 0 
29 29 29 41 11 17 17 22 2 24 11 11 11 11 11 11 17 17 17 17 17 11 11 0 0 0 0 0 0 0 0 0 
11 11 11 11 11 11 17 17 17 17 17 17 17 17 17 17 11 17 17 11 11 11 11 0 0 0 0 0 0 0 0 0 
11 11 11 11 11 11 11 11 11 11 11 11 11 11 11 11 11 11 11 11 11 11 11 0 0 0 0 0 0 0 0 0 
0 0 0 0 0 0 0 0 0 0 0 0 0 0 0 0 0 0 0 0 0 0 0 0 0 0 0 0 0 0 0 0 
0 0 0 0 0 0 0 0 0 0 0 0 0 0 0 0 0 0 0 0 0 0 0 0 0 0 0 0 0 0 0 0 
0 0 0 0 0 0 0 0 0 0 0 0 0 0 0 0 0 0 0 0 0 0 0 0 0 0 0 0 0 0 0 0 
0 0 0 0 0 0 0 0 0 0 0 0 0 0 0 0 0 0 0 0 0 0 0 0 0 0 0 0 0 0 0 0 
0 0 0 0 0 0 0 0 0 0 0 0 0 0 0 0 0 0 0 0 0 0 0 0 0 0 0 0 0 0 0 0 
0 0 0 0 0 0 0 0 0 0 0 0 0 0 0 0 0 0 0 0 0 0 0 0 0 0 0 0 0 0 0 0 
0 0 0 0 0 0 0 0 0 0 0 0 0 0 0 0 0 0 0 0 0 0 0 0 0 0 0 0 0 0 0 0 
0 0 0 0 0 0 0 0 0 0 0 0 0 0 0 0 0 0 0 0 0 0 0 0 0 0 0 0 0 0 0 0 
0 0 0 0 0 0 0 0 0 0 0 0 0 0 0 0 0 0 0 0 0 0 0 0 0 0 0 0 0 0 0 0 
0 0 0 0 0 0 0 0 0 0 0 0 0 0 0 0 0 0 0 0 0 0 0 0 0 0 0 0 0 0 0 0 
0 0 0 0 0 0 0 0 0 0 0 0 0 0 0 0 0 0 0 0 0 0 0 0 0 0 0 0 0 0 0 0 
0 0 0 0 0 0 0 0 0 0 0 0 0 0 0 0 0 0 0 0 0 0 0 0 0 0 0 0 0 0 0 0 
0 0 0 0 0 0 0 0 0 0 0 0 0 0 0 0 0 0 0 0 0 0 0 0 0 0 0 0 0 0 0 0 
0 0 0 0 0 0 0 0 0 0 0 0 0 0 0 0 0 0 0 0 0 0 0 0 0 0 0 0 0 0 0 0 
0 0 0 0 0 0 0 0 0 0 0 0 0 0 0 0 0 0 0 0 0 0 0 0 0 0 0 0 0 0 0 0 
0 0 0 0 0 0 0 0 0 0 0 0 0 0 0 0 0 0 0 0 0 0 0 0 0 0 0 0 0 0 0 0 
0 0 0 0 0 0 0 0 0 0 0 0 0 0 0 0 0 0 0 0 0 0 0 0 0 0 0 0 0 0 0 0 
0 0 0 0 0 0 0 0 0 0 0 0 0 0 0 0 0 0 0 0 0 0 0 0 0 0 0 0 0 0 0 0 
0 0 0 0 0 0 0 0 0 0 0 0 0 0 0 0 0 0 0 0 0 0 0 0 0 0 0 0 0 0 0 0