11 11 40 11 11 11 11 11 11 11 11 49 11 11 11 11 11 16 28 29 30 11 37 38 39 11 28 29 30 11 11 11 
20 20 20 20 20 20 20 20 20 20 45 17 17 17 17 17 17 16 37 38 39 17 46 47 48 11 37 38 39 11 11 11 
33 33 33 33 33 33 33 33 33 33 10 40 17 49 17 17 17 16 46 47 48 40 17 17 17 17 46 47 48 28 29 30 
33 33 33 33 33 33 33 33 33 33 10 17 17 17 17 40 17 16 17 17 28 29 30 28 29 30 17 17 17 37 38 39 
2 2 2 2 2 2 2 3 33 33 19 45 17 49 11 11 11 16 40 11 37 38 39 37 38 39 40 40 11 46 47 48 
8 8 8 8 8 8 9 12 33 33 33 10 17 17 17 17 17 16 17 40 46 47 48 46 47 48 40 40 28 29 30 17 
49 28 29 30 17 40 18 12 33 33 33 10 40 40 40 17 17 16 17 17 17 17 28 29 30 17 17 17 37 38 39 17 
17 37 38 39 40 17 18 12 33 33 33 10 40 40 40 17 17 16 28 29 30 17 37 38 39 28 29 30 46 47 48 11 
17 46 47 48 17 17 18 12 33 33 33 10 40 40 40 17 17 16 37 38 39 40 46 47 48 37 38 39 11 11 11 11 
28 29 30 28 29 30 18 12 33 33 33 10 17 17 17 17 17 16 46 47 48 17 17 17 17 46 47 48 17 17 17 17 
37 38 39 37 38 39 18 12 33 33 33 19 45 17 17 17 17 25 26 26 26 26 26 26 26 26 26 26 26 26 26 26 
46 47 48 46 47 48 18 12 33 33 33 33 19 20 20 20 45 17 17 17 17 17 17 17 17 17 17 17 17 17 17 17 
26 26 26 26 26 26 27 12 33 33 33 33 33 33 33 33 19 20 20 45 17 49 17 17 17 17 17 17 17 17 17 17 
17 17 17 17 17 17 17 12 33 33 50 33 33 33 33 33 33 33 33 19 20 45 17 17 17 17 17 49 17 17 17 17 
17 17 17 17 17 17 17 12 33 33 33 33 33 33 33 33 33 33 33 33 33 19 45 17 17 49 17 17 17 17 17 17 
17 17 40 17 44 20 20 21 33 33 33 1 3 33 33 33 33 33 33 33 33 33 10 17 17 17 17 17 17 17 17 17 
17 17 17 44 21 33 33 33 33 33 33 19 21 33 33 33 33 33 33 33 33 33 10 42 23 23 23 23 43 17 17 17 
17 17 17 12 33 33 33 1 3 33 33 33 33 33 33 50 33 33 33 33 33 1 42 24 36 36 36 36 22 43 11 11 
17 40 17 12 33 33 33 19 21 33 33 33 33 33 33 33 33 33 1 2 42 23 24 36 14 14 14 14 36 13 17 17 
17 17 17 53 3 33 33 33 33 33 33 33 33 1 2 2 2 2 54 42 24 36 36 14 14 14 14 14 36 13 49 11 
17 17 17 17 53 2 2 2 2 2 2 2 2 54 17 17 17 17 42 24 36 14 14 14 14 14 14 14 36 13 17 17 
17 17 17 40 17 17 49 17 17 40 17 17 17 40 17 17 42 23 24 36 14 14 14 14 14 14 14 14 36 13 17 17 
17 17 17 17 17 17 17 17 17 17 17 17 17 17 17 42 24 36 36 14 14 14 14 14 14 14 14 36 4 52 17 11 
17 17 17 17 17 17 17 7 8 8 9 17 49 17 42 24 36 14 14 14 14 14 14 14 14 14 14 36 13 17 17 11 
17 17 17 17 7 8 8 28 29 30 18 17 17 42 24 36 14 14 14 14 14 14 14 14 14 14 14 36 13 17 17 17 
8 8 8 8 17 17 17 37 38 39 18 17 17 15 36 14 14 14 14 14 14 14 14 14 14 14 36 4 52 17 17 17 
11 11 28 29 30 11 11 46 47 48 18 17 42 24 36 14 14 14 14 14 14 14 14 36 36 36 4 52 17 17 17 17 
17 17 37 38 39 17 17 17 17 17 18 17 15 36 14 14 14 14 14 14 36 36 36 4 5 5 52 11 11 11 11 11 
17 17 46 47 48 17 17 17 17 17 18 17 15 36 14 14 14 14 36 36 4 5 5 52 17 17 17 17 17 17 17 17 
28 29 30 17 17 28 29 30 17 26 27 17 51 6 36 14 14 36 4 5 52 17 17 17 17 17 17 17 17 17 17 17 
37 38 39 17 17 37 38 39 18 17 17 17 17 15 36 36 36 4 17 17 17 17 17 17 17 17 17 17 17 17 17 17 
46 47 48 17 17 46 47 48 18 17 17 17 17 51 5 5 5 52 17 17 17 17 17 17 17 17 17 17 17 17 17 17