7 17 17 49 49 28 29 30 17 18 17 12 33 33 33 33 33 33 33 33 33 33 33 33 33 33 33 33 10 17 7 17 17 17 40 40 17 28 29 30 
17 28 29 30 49 37 38 39 40 18 17 12 33 33 33 33 33 33 33 33 33 33 33 33 33 33 33 33 10 17 16 28 29 30 40 40 17 37 38 39 
17 37 38 39 17 46 47 48 40 18 17 53 3 33 33 33 33 33 33 33 33 33 33 33 33 33 1 2 54 17 16 37 38 39 28 29 30 46 47 48 
17 46 47 48 17 17 28 29 30 18 17 17 53 3 33 33 33 33 33 33 33 33 33 33 33 33 10 17 17 17 16 46 47 48 37 38 39 17 40 40 
40 40 17 28 29 30 37 38 39 18 17 17 17 53 2 3 33 33 33 33 33 33 33 33 33 1 54 17 17 17 16 28 29 30 46 47 48 17 40 40 
40 40 17 37 38 39 46 47 48 18 17 17 17 17 17 53 2 2 2 2 2 2 2 2 2 54 17 17 17 17 16 37 38 39 17 17 17 28 29 30 
28 29 30 46 47 48 28 29 30 18 17 17 17 17 17 17 17 17 17 17 17 17 17 17 17 17 17 17 17 17 16 46 47 48 28 29 30 37 38 39 
37 38 39 49 49 49 37 38 39 18 17 17 17 17 17 17 17 17 17 17 17 17 17 17 17 17 17 17 17 17 16 40 40 17 37 38 39 46 47 48 
46 47 48 40 40 17 46 47 48 18 17 17 17 17 17 17 17 17 17 17 17 17 17 17 17 17 17 17 17 17 16 40 40 17 46 47 48 49 49 17 
26 26 26 26 26 26 26 26 26 27 17 17 17 17 17 17 17 17 17 17 17 17 17 17 17 17 17 17 17 17 25 26 26 26 26 26 26 26 26 26 
17 17 17 17 17 17 17 17 17 17 17 17 17 17 17 17 17 17 17 17 17 17 17 17 17 17 17 17 17 17 17 17 17 17 17 17 17 17 17 17 
17 17 17 17 17 17 17 17 17 17 17 17 17 17 17 17 17 17 17 17 17 17 17 17 17 17 17 17 17 17 17 17 17 17 17 17 17 17 17 17 
17 17 17 17 17 17 17 17 17 17 17 17 17 17 17 17 17 17 44 20 20 20 20 45 17 17 17 17 17 17 17 17 17 17 17 17 17 17 17 17 
20 45 17 17 17 17 17 17 17 17 17 17 17 17 17 44 20 20 21 33 33 33 33 19 20 20 17 17 17 17 17 17 17 17 17 17 17 17 17 17 
33 19 20 45 17 17 17 17 17 17 17 17 17 17 44 21 33 33 33 33 33 33 33 33 33 33 19 45 17 17 17 17 17 17 17 17 17 17 17 17 
33 33 33 19 45 17 17 17 17 17 17 17 17 17 21 33 33 33 33 33 33 33 33 33 33 33 33 10 17 17 17 17 17 17 17 17 17 17 17 17 
33 33 33 33 19 45 17 17 17 17 17 17 17 12 33 33 33 33 33 33 33 33 33 33 33 33 33 19 17 17 17 17 17 17 17 17 17 44 20 20 
33 33 33 33 33 19 17 17 17 17 17 17 44 21 33 33 33 33 33 33 33 33 33 33 33 33 33 33 19 45 17 17 17 17 17 17 44 21 33 33 
33 33 33 33 33 33 10 17 17 17 17 17 12 33 33 33 33 33 33 33 33 33 33 33 33 33 33 33 33 10 17 17 17 17 17 44 21 33 33 33 
33 33 33 33 33 33 10 17 17 17 17 44 21 33 33 33 33 33 33 33 33 33 33 33 33 33 33 33 33 10 17 17 17 17 44 21 33 33 33 33 
33 33 33 33 33 33 10 17 17 17 17 12 33 33 33 33 33 33 33 33 7 8 8 8 8 8 8 8 8 9 17 17 17 17 12 33 33 33 33 33 
33 33 33 33 33 33 19 20 20 20 20 21 33 33 33 33 33 33 33 33 16 42 23 23 23 23 43 40 40 18 17 17 17 44 21 33 33 33 33 33 
33 33 33 33 33 33 1 2 2 2 2 2 3 33 33 33 33 33 33 33 16 15 14 14 14 14 13 40 40 18 17 17 44 21 33 33 33 33 33 33 
33 33 33 33 33 33 10 17 17 17 17 17 12 33 33 33 33 33 33 33 16 15 14 14 14 14 22 43 17 18 17 17 12 33 33 33 33 33 33 33 
33 33 33 33 33 33 10 17 17 17 17 17 12 33 33 33 33 33 33 33 16 15 14 4 5 6 14 22 43 18 17 17 12 33 33 33 33 33 33 33 
33 33 33 33 33 33 10 17 17 17 17 17 12 33 33 33 33 33 33 33 16 15 14 13 40 15 14 14 13 18 17 17 12 33 33 33 33 33 33 33 
33 33 33 33 33 1 54 17 17 17 17 17 53 3 33 33 33 33 33 33 16 15 14 22 23 24 14 14 13 18 17 17 12 33 33 33 33 33 33 33 
33 33 33 33 1 54 17 17 17 17 17 17 17 17 3 33 33 33 33 33 16 15 14 14 14 14 14 14 13 18 17 17 53 3 33 33 33 33 33 33 
33 33 1 2 54 17 17 17 17 17 17 17 17 17 53 2 2 3 33 1 16 51 5 5 5 5 5 5 52 18 17 17 17 12 33 33 33 33 33 33 
2 2 54 17 17 17 17 17 17 17 17 17 17 17 17 17 17 53 2 54 25 26 26 26 26 26 26 26 26 27 17 17 17 53 3 33 33 33 33 33 
7 8 8 8 8 8 8 8 8 9 17 17 17 17 17 17 17 17 17 17 17 17 17 17 17 17 17 17 17 17 17 17 17 17 53 3 33 33 33 33 
42 23 23 23 23 23 23 43 49 18 17 17 17 17 17 17 17 17 17 17 17 17 17 17 17 17 17 17 17 17 17 17 17 17 17 53 2 2 3 33 
15 14 14 14 14 14 14 22 43 18 17 17 17 17 17 17 17 17 17 17 17 17 44 20 20 20 45 17 17 17 17 17 17 17 17 17 17 17 53 2 
51 5 6 14 14 14 14 14 13 18 17 17 17 17 17 17 17 17 17 17 17 44 21 33 33 33 19 45 17 17 17 17 17 17 7 8 8 8 8 8 
40 40 15 14 14 14 14 14 13 18 17 17 17 17 17 17 17 17 17 17 44 21 33 33 33 33 33 20 20 20 20 20 45 17 16 49 49 17 17 17 
17 40 15 14 14 14 14 14 13 18 17 17 17 17 17 17 17 17 17 17 12 33 33 33 33 33 33 33 33 33 33 33 10 17 16 49 28 29 30 17 
17 49 51 5 6 14 14 4 52 18 17 17 17 17 17 17 17 17 17 17 12 33 33 33 33 33 33 33 33 33 33 33 10 17 16 17 37 38 39 17 
28 29 30 40 40 5 5 40 40 18 17 17 17 17 17 17 17 17 17 17 12 33 33 33 33 33 33 33 33 33 33 33 10 17 16 40 46 47 48 17 
37 38 39 49 40 40 40 40 40 18 17 17 17 17 17 17 17 17 17 17 12 33 33 33 33 33 33 33 33 33 33 1 54 17 16 40 17 40 17 17 
46 47 48 17 17 17 40 40 40 18 17 17 17 17 17 17 17 17 17 17 12 33 33 33 33 33 33 33 33 33 1 54 17 17 16 40 40 40 17 17